m1co.xml	Ranger des images dans l’ordre de l’histoire. (exercice avec exemple)
m1c1_s1.xml	Ranger des images dans l’ordre de l’histoire. (exercice 1)
m1c1_s2.xml	Ranger des images dans l’ordre de l’histoire. (exercice 1 : variante)
m1c2.xml	Ranger des images dans l’ordre de l’histoire à partir d’un texte complexe. (exercice 2)
m1cgp0.xml	Effectuer un classement de mots en fonction du nombre de syllabes. (exercice avec exemple)
m1cgp1_s1.xml	Effectuer un classement de mots en fonction du nombre de syllabes. (exercice 1)
m1cgp1_s2.xml	Effectuer un classement de mots en fonction du nombre de syllabes. (exercice 1 : variante)
m1cgp2.xml	Effectuer un classement de mots moins fréquents en fonction du nombre de syllabes. (exercice 2)
m1cgpr1_1.xml	Reconstituer  des illustrations de mots en fonction du nombre de syllabes.  (remédiation 1)
m1cgpr1_2.xml	Reconstituer  des illustrations de mots en fonction du nombre de syllabes.  (remédiation 1)
m1cgpr2.xml	Effectuer un classement de mots en fonction du nombre de syllabes appuyées  par un balisage sonore. (remédiation 2)
m1coe0.xml	Choisir parmi trois proposés et en fonction de la quantité, l’écrit correspondant à ce qui est lu par l’adulte. (exercice avec exemple)
m1coe1_s1.xml	Choisir parmi trois proposés et en fonction de la quantité, l’écrit correspondant à ce qui est lu par l’adulte. (exercice 1)	
m1coe1_s2.xml	Choisir parmi trois proposés et en fonction de la quantité, l’écrit correspondant à ce qui est lu par l’adulte. (exercice 1 : variante)
m1coe2.xml	Choisir parmi trois proposés et en fonction de la quantité, l’écrit correspondant à ce qui est lu par l’adulte. (exercice 2)                     
m1coer1.xml	Choisir parmi deux proposés et en fonction de la quantité, l’écrit correspondant à ce qui est lu par l’adulte. (remédiation 1)
m1cr1.xml	Ranger des images dans l’ordre de l’histoire à partir d’un texte court. (remédiation 1)
m1cr2.xml	Mettre en correspondance  le début et la fin d’une histoire. (remédiation 2)
m1fl0.xml	Reconnaître et sélectionner les lettres parmi différents caractères . (exercice avec exemple)
m1fl1_s1.xml	Reconnaître et sélectionner les lettres parmi différents caractères . (exercice 1)
m1fl1_s2.xml	Reconnaître et sélectionner les lettres parmi différents caractères . (exercice 1)
m1fl2.xml	Pour le reconstituer, sélectionner les lettres d’un mot, données dans une typologie d’écriture différente. (exercice 2)
m1flr1.xml	Reconnaître et sélectionner les lettres parmi une liste de chiffres et de lettres. (remédiation 1)
m1flr2.xml	Mettre en correspondance les différentes typologies d’écriture d’une même lettre. (remédiation 2)
m1flr2_2.xml	Mettre en correspondance les différentes typologies d’écriture d’une même lettre. (remédiation 2 : variante)	 
m1v0.xml	Sélectionner parmi trois l’image correspondant au mot entendu. (exercice avec exemple)
m1v1_s1.xml	Sélectionner parmi trois l’image correspondant au mot entendu. (exercice 1)
m1v1_s2.xml	Sélectionner parmi trois l’image correspondant au mot entendu. (exercice 1 : variante)
m1v2.xml	Sélectionner parmi trois l’image correspondant au mot entendu ( vocabulaire élaboré). (exercice 2)
m1vr1_s1.xml	Sélectionner parmi  cinq l’image correspondant au mot et à sa définition . (remédiation 1)
m1vr1_s2.xml	Sélectionner parmi  cinq l’image correspondant au mot et à sa définition . (remédiation 1 : variante)
m2c0_s1.xml	Relier une consigne écrite et son illustration.	(exercice avec exemple)
m2c0_s2.xml	Relier une consigne écrite et son illustration. (exercice avec exemple : variante)
m2c1_s1.xml	Relier une consigne écrite et son illustration. (exercice 1)
m2c1_s2.xml	Relier une consigne écrite et son illustration. (exercice 1 : variante)
m2c2.xml	Sélectionner parmi cinq consignes proches celle qui correspond à l’illustration. (exercice 2)
m2cgp0_s1.xml	Effectuer un classement de mots en fonction d’un phonème donné. (exercice avec exemple)
m2cgp0_s2.xml	Effectuer un classement de mots en fonction d’un phonème donné. (exercice avec exemple : variante)
m2cgp1_s1.xml	Effectuer un classement de mots en fonction d’un phonème donné. (exercice 1)
m2cgp1_s2.xml	Effectuer un classement de mots en fonction d’un phonème donné. (exercice 1 : variante)
m2cgp2_s1.xml	Effectuer un classement de mots en fonction d’un phonème donné. (exercice 2)
m2cgp2_s2.xml	Effectuer un classement de mots en fonction d’un phonème donné. (exercice 2 : variante)
m2cgp2_s3.xml	Effectuer un classement de mots en fonction d’un phonème donné. (exercice 2 : variante)
m2cgpr1.xml	Sélectionner un mot parmi deux en fonction du phonème donné. (remédiation 1)
m2cgpr1_1.xml	Sélectionner un mot parmi deux en fonction du phonème donné. (remédiation 1 : variante)
m2cgpr1_2.xml	Sélectionner un mot parmi deux en fonction du phonème donné. (remédiation 1 : variante)
m2cgpr2.xml	Localiser un son donné.(remédiation 2)
m2coe0.xml	Repérer un mot dans une phrase de 5 ou 6 mots lue par l’adulte. (exercice avec exemple)
m2coe1_s1.xml	Repérer un mot dans une phrase de 5 ou 6 mots lue par l’adulte. (exercice 1)
m2coe1_s2.xml	Repérer un mot dans une phrase de 5 ou 6 mots lue par l’adulte. (exercice 1 : variante)
m2coe2_1.xml	Repérer un mot dans une phrase de 3 ou 4 mots lue par l’adulte. (exercice 2)
m2coe2_2.xml	Repérer un mot dans une phrase de 3 ou 4 mots lue par l’adulte. (exercice 2 : variante)
m2coer1.xml	Repérer un mot dans une phrase de 3 ou 4 mots lue par l’adulte. (remédiation 1)
m2coer2.xml	Au sein d’une phrase, repérer un mot dans un groupe de mots soulignés. (remédiation 2)                                                                                                                     
m2cr1_1.xml	Mettre en relation une consigne énoncée et son illustration hors contexte. (remédiation 1)
m2cr1_2.xml	Mettre en relation une consigne énoncée et son illustration hors contexte. (remédiation 1 : variante)
m2fl0.xml	Séparer les mots d’une phrase. (6 mots) (exercice avec exemple)
m2fl1_s1.xml	Séparer les mots d’une phrase. (6 mots) (exercice 1)
m2fl1_s2.xml	Séparer les mots d’une phrase. (6 mots) (exercice 1)
m2fl2.xml	Séparer les mots d’une phrase complexe (apostrophes, négatives…) (exercice 2)
m2flr1.xml	Séparer les mots d’une phrase. (3 ou 4 mots) (remédiation 1)
m2v0.xml	Classer des mots en fonction de leur appartenance à une catégorie lexicale (le générique étant donné). (exercice avec exemple)
m2v1_s1.xml	Classer des mots en fonction de leur appartenance à une catégorie lexicale (le générique étant donné). (exercice 1)
m2v1_s2.xml	Classer des mots en fonction de leur appartenance à une catégorie lexicale (le générique étant donné). (exercice 1)
m2v1_s3.xml	Classer des mots en fonction de leur appartenance à une catégorie lexicale (le générique étant donné). (exercice 1)
m2v2.xml	Trouver l’intrus dans une catégorie lexicale. (exercice 2)
m2vr1.xml	Trouver le générique d’une catégorie. (remédiation 1)
m3c0.xml	Reconstituer des phrases dont les mots sont dans le désordre.(6 mots) (exercice avec exemple)
m3c1_s1.xml	Reconstituer des phrases dont les mots sont dans le désordre.(6 mots) (exercice 1)
m3c1_s2.xml	Reconstituer des phrases dont les mots sont dans le désordre.(6 mots) (exercice 1 : variante)
m3c2.xml	Reconstituer des phrases dont les mots sont dans le désordre..  (8 mots) (exercice 2)
m3cgp0.xml	Choisir une syllabe dans une liste pour compléter un mot illustré. (exercice avec exemple)
m3cgp1_s1.xml	Choisir une syllabe dans une liste pour compléter un mot illustré. (exercice 1)
m3cgp1_s2.xml	Choisir une syllabe dans une liste pour compléter un mot illustré. (exercice 1 : variante)
m3cgp1_s3.xml	Choisir une syllabe dans une liste pour compléter un mot illustré. (exercice 1 : variante)
m3cgp1_s4.xml	Choisir une syllabe dans une liste pour compléter un mot illustré. (exercice 1 : variante)
m3cgp2_0.xml	Reconstituer un mot dont les syllabes sont données dans le désordre. (exercice avec exemple)
m3cgp2_s1.xml	Reconstituer un mot dont les syllabes sont données dans le désordre. (exercice 2)
m3cgp2_s2.xml	Reconstituer un mot dont les syllabes sont données dans le désordre. (exercice 2 : variante)
m3cgpr0.xml	Choisir une syllabe parmi deux pour compléter un mot illustré. (exercice avec exemple)
m3cgpr1.xml	Choisir une syllabe parmi deux pour compléter un mot illustré. (remédiation 1)
m3cgpr2.xml	Choisir une syllabe parmi deux proches pour compléter un mot illustré. (remédiation 2)
m3coe0_s1.xml	Parmi quatre mots contenant un fragment écrit commun, repérer celui dont le fragment  commun ne s’entend pas de la même manière. (exercice avec exemple)
m3coe0_s2.xml	Parmi quatre mots contenant un fragment écrit commun, repérer celui dont le fragment  commun ne s’entend pas de la même manière. (exercice avec exemple : variante)
m3coe1_s1.xml	Parmi quatre mots contenant un fragment écrit commun, repérer celui dont le fragment  commun ne s’entend pas de la même manière. (exercice 1)
m3coe1_s2.xml	Parmi quatre mots contenant un fragment écrit commun, repérer celui dont le fragment  commun ne s’entend pas de la même manière. (exercice 1 : variante)
m3coe2.xml	Parmi quatre mots contenant un fragment écrit commun, repérer celui dont le fragment  commun ne s’entend pas de la même manière. (exercice 2)
m3coer1.xml	Effectuer un classement de mots en fonction d’un phonème donné. (remédiation 1)
m3cr1.xml	Reconstituer des phrases dont les mots sont dans le désordre. (4 mots) (remédiation 1)
m3cr2.xml	Reconstituer des phrases à l’aide d’étiquettes, le premier et le dernier mot étant donnés.  (6 mots) (remédiation 2)
m3fl0.xml	Identifier les lettres majuscules et les signes de ponctuation d’un texte. (exercice avec exemple)
m3fl1_s1.xml	Identifier les lettres majuscules et les signes de ponctuation d’un texte. (exercice 1)
m3fl1_s2.xml	Identifier les lettres majuscules et les signes de ponctuation d’un texte. (exercice 1 : variante)
m3fl2.xml	Identifier les lettres majuscules et les signes de ponctuation d’un texte en écriture cursive. (exercice 2)
m3flr1.xml	Identifier les majuscules dans une série de lettres. (remédiation 1)
m3flr2.xml	Identifier les signes de ponctuation dans une série de caractères. (remédiation 2)
m3v0.xml	Rassembler les mots d’une même famille. (exercice avec exemple)
m3v1_s1.xml	Rassembler les mots d’une même famille. (exercice 1)
m3v1_s2.xml	Rassembler les mots d’une même famille. (exercice 1 : variante)
m3v2.xml	Rassembler les mots d’une même famille. ( quatre familles de mots proches) (exercice 2)
m3vr1.xml	Se servir de la racine des mots pour rapprocher ceux de la même famille. (remédiation 1) 
m4c1_s1.xml	Souligner dans le texte les réponses aux questions données. (exercice 1)
m4c1_s2.xml	Souligner dans le texte les réponses aux questions données. (exercice 1: variante)
m4c2.xml	Souligner dans un texte complexe les réponses aux questions données. (exercice 2)
m4cgp1_s1_1.xml	Choisir le mot phonétiquement correct pour compléter une phrase. (exercice 1)	
m4cgp1_s1_2.xml	Choisir le mot phonétiquement correct pour compléter une phrase. (exercice 1 : variante)
m4cgp1_s2_1.xml	Choisir le mot phonétiquement correct pour compléter une phrase. (exercice 1 : variante)
m4cgp1_s2_2.xml	Choisir le mot phonétiquement correct pour compléter une phrase. (exercice 1 : variante)
m4cgp2.xml	Ecrire des syllabes sous la dictée. (exercice 2)
m4cgpr1.xml	Choisir parmi deux phonèmes proches celui qui convient pour compléter un mot. (remédiation 1)
m4coe1_s1.xml	Repérer des lettres muettes dans un texte. (exercice 1)
m4coe1_s2.xml	Repérer des lettres muettes dans un texte. (exercice 1 : variante)
m4coe2.xml	Repérer parmi deux mots se terminant par la même lettre, celui dont la lettre finale est  muette. (exercice 2)                                                                                                           
m4coer1.xml	Repérer des lettres muettes dans des mots. (remédiation 1)                                                                                     
m4coer2.xml	Effectuer un classement de mots en fonction de la valeur de la lettre « h ». (remédiation 2)
m4cr1.xml	Cocher la réponse à la question donnée. (remédiation 1)
m4cr2.xml	Retrouver et souligner dans une phrase le groupe de mots contenant la réponse à la question donnée. (remédiation 2)
m4fl1_s1_1.xml	Sélectionner le déterminant qui convient. (exercice 1)
m4fl1_s1_2.xml	Sélectionner le déterminant qui convient. (exercice 1 : variante)
m4fl2.xml	Appliquer une transformation en genre ou en nombre. ( exercice 2)
m4flr1_1.xml	Sélectionner le déterminant qui convient en fonction du genre. (remédiation 1)
m4flr1_2.xml	Sélectionner le déterminant qui convient en fonction du genre. (remédiation 1 : variante)
m4flr2_1.xml	Sélectionner le déterminant qui convient en fonction du nombre. (remédiation 2)
m4flr2_2.xml	Sélectionner le déterminant qui convient en fonction du nombre. (remédiation 2 : variante)
m4v1_s1.xml	Choisir le synonyme d’un mot parmi trois proposés.(exercice 1)
m4v1_s1_1.xml	Choisir le synonyme d’un mot parmi trois proposés.(exercice 1 : variante)
m4v1_s1_2.xml	Choisir le synonyme d’un mot parmi trois proposés.(exercice 1 : variante)
m4v1_s2.xml	Mettre en relation deux phrases synonymes.(exercice 2)
m4v1_s2_1.xml	Mettre en relation deux phrases synonymes.(exercice 2 : variante)
m4v1_s2_2.xml	Mettre en relation deux phrases synonymes.(exercice 2 : variante)
m4v1r1.xml	Mettre en relation deux synonymes. (remédiation 1)
m4v2.xml	Mettre en relation deux phrases synonymes. (exercice 2)
m4vr1_1.xml	Mettre en relation deux synonymes. (remédiation 1)
m4vr1_2.xml	Mettre en relation deux synonymes. (remédiation 1)
m5c1_s1.xml	Reconstituer un texte dont les phrases sont dans le désordre. (exercice 1)	
m5c1_s2.xml	Reconstituer un texte dont les phrases sont dans le désordre. (exercice 1 : variante)
m5c2.xml	Reconstituer un texte complexe dont les phrases sont dans le désordre. (exercice 2)
m5cgp1_s1.xml	Choisir parmi deux phonèmes proches celui qui convient pour compléter un mot. (exercice 1)
m5cgp1_s2.xml	Choisir parmi deux phonèmes proches celui qui convient pour compléter un mot. (exercice 1 : variante)
m5cgp2.xml	Compléter  des mots d’un texte avec des groupes de lettres donnés. (exercice 2)
m5cgpr1.xml	Effectuer un classement de mots en fonction d’un phonème donné. (remédiation 1)
m5coe1_s1.xml	Dénombrer les phrases d’un texte ponctuées par des points. (exercice 1)                                                                                        
m5coe1_s2.xml	Dénombrer les phrases d’un texte ponctuées par des points. (exercice 1 : variante) 
m5coe2.xml	Dénombrer les phrases d’un texte ponctuées par des signes variés ( ? ! …) (exercice 2)                                                                                        
m5coer1.xml	Repérer les indices morphosyntaxiques permettant d’identifier une phrase (majuscule et point). (remédiation 1)
m5cr1.xml	Sélectionner parmi trois propositions la fin d’un texte. (remédiation 1)
m5cr2.xml	Reconstituer le milieu d’une histoire en ordonnant les phrases (le début et la fin de l’histoire étant donnés) (remédiation 2)
m5fl1_s1.xml	Sélectionner le pronom qui convient pour remplacer un groupe nominal sujet dans une phrase. (exercice 1)
m5fl1_s2.xml	Sélectionner le pronom qui convient pour remplacer un groupe nominal sujet dans une phrase. (exercice 1 : variante)
m5flr1.xml	Mettre en correspondance des groupes nominaux  et des pronoms en fonction du genre. (remédiation 1)
m5flr2.xml	Mettre en correspondance des groupes nominaux  et des pronoms en fonction du genre. (remédiation 2)
m5v1_s1.xml	Ranger des mots dans l’ordre alphabétique. (exercice 1)
m5v1_s2.xml	Ranger des mots dans l’ordre alphabétique. (exercice 1 : variante)
m5v2.xml	Dans une liste de mots rangés dans l’ordre alphabétique, sélectionner celui qui n’est pas à sa place. (exercice 2)
m5vr1.xml	Ranger des lettres dans l’ordre alphabétique. (remédiation 1)
m5vr2.xml	Ranger des mots dans l’ordre alphabétique, pas de proximité dans les initiales. (remédiation 2)
m6c1_s1_1.xml	Souligner dans le texte les réponses aux questions données. (exercice 1)
m6c1_s1_2.xml	Souligner dans le texte les réponses aux questions données. (exercice 1 : variante)
m6c1_s1_3.xml	Souligner dans le texte les réponses aux questions données. (exercice 1 : variante)
m6c1_s1_4.xml	Souligner dans le texte les réponses aux questions données. (exercice 1 : variante)
m6c1_s2_1.xml	Souligner dans le texte les réponses aux questions données. (exercice 1 : variante)
m6c1_s2_2.xml	Souligner dans le texte les réponses aux questions données. (exercice 1 : variante)
m6c1_s2_3.xml	Souligner dans le texte les réponses aux questions données. (exercice 1 : variante)
m6c1_s2_4.xml	Souligner dans le texte les réponses aux questions données. (exercice 1 : variante)
m6c2_s1_1.xml	Souligner dans un texte complexe les réponses aux questions données. (exercice 2)
m6c2_s1_2.xml	Souligner dans un texte complexe les réponses aux questions données. (exercice 2 : variante)
m6c2_s1_3.xml	Souligner dans un texte complexe les réponses aux questions données. (exercice 2 : variante)
m6c2_s1_4.xml	Souligner dans un texte complexe les réponses aux questions données. (exercice 2 : variante)
m6cgp1_s1.xml	A partir d’un indice, trouver et  reconstituer un mot dont les lettres sont données dans le désordre. (exercice 1)	
m6cgp1_s2.xml	A partir d’un indice, trouver et  reconstituer un mot dont les lettres sont données dans le désordre. (exercice 1 : variante)	
m6cgp2_1.xml	Retrouver deux mots illustrés dont les lettres ont été mélangées ensemble. (exercice 2)
m6cgp2_1_1.xml	Retrouver deux mots illustrés dont les lettres ont été mélangées ensemble. (exercice 2 : variante)
m6cgp2_2.xml	Retrouver deux mots illustrés dont les lettres ont été mélangées ensemble. (exercice 2 : variante)
m6cgp2_2_1.xml	Retrouver deux mots illustrés dont les lettres ont été mélangées ensemble. (exercice 2 : variante)
m6cgpr1.xml	Trouver et  reconstituer un mot illustré dont les lettres sont données dans le désordre, la première étant déjà placée. (remédiation 1)
m6coe1_s1.xml	Parmi des mots qui se ressemblent, trouver celui qui correspond à l’illustration. (exercice 1)
m6coe1_s2.xml	Parmi des mots qui se ressemblent, trouver celui qui correspond à l’illustration. (exercice 1 : variante)
m6coe2.xml	Parmi trois mots proches et complexes, trouver celui qui est lu par l’adulte. (exercice 2)	
m6coer1.xml	Parmi deux mots qui se ressemblent, trouver celui qui correspond à l’illustration.(remédiation 1)
m6cr1.xml	Reconstituer un texte injonctif dont les phrases sont dans le désordre. (chronologie) (remédiation 1)
m6cr2.xml	Mettre en relation une phrase et son illustration en fonction de l’action. (remédiation 2)
m6fl1_s1.xml	Sélectionner la forme verbale correspondant au pronom personnel sujet donné. (exercice 1)
m6fl1_s2.xml	Sélectionner la forme verbale correspondant au pronom personnel sujet donné. (exercice 1 : variante)
m6fl2.xml	Ecrire la terminaison du verbe en fonction du sujet. (exercice 2)
m6flr1.xml	Sélectionner le pronom personnel sujet correspondant à la forme verbale donnée. (remédiation 1)
m6v1_s1_1.xml	Compléter des phrases avec des homonymes. (exercice 1)
m6v1_s1_2.xml	Compléter des phrases avec des homonymes. (exercice 1 : variante)
m6v1_s2_1.xml	Compléter des phrases avec des homonymes. (exercice 1 : variante)
m6v1_s2_2.xml	Compléter des phrases avec des homonymes. (exercice 1 : variante)
m6v2.xml	Parmi trois proposés, sélectionner le mot qui n’est pas un homonyme des deux autres. (exercice 2)
m6vr1_1.xml	Effectuer un classement de mots en fonction de leur homonymie. (remédiation 1)
m6vr1_2.xml	Effectuer un classement de mots en fonction de leur homonymie. (remédiation 1 : variante)
m6vr1_3.xml	Effectuer un classement de mots en fonction de leur homonymie. (remédiation 1 : variante)
m7c1_s1_1.xml	Répondre à une question portant sur un texte entendu (caché). (exercice 1)
m7c1_s1_2.xml	Répondre à une question portant sur un texte entendu (caché). (exercice 1 : variante)
m7c1_s2_1.xml	Répondre à une question portant sur un texte entendu (caché). (exercice 1 : variante)
m7c1_s2_2.xml	Répondre à une question portant sur un texte entendu (caché). (exercice 1 : variante)
m7c2_1.xml	Répondre à deux questions portant sur un texte complexe entendu (caché). (exercice 2)
m7c2_2.xml	Répondre à deux questions portant sur un texte complexe entendu (caché). (exercice 2 : variante)
m7cgp1_s1.xml	Compléter les mots d’un texte en écrivant les lettres manquantes. (exercice 1)
m7cgp1_s2.xml	Compléter les mots d’un texte en écrivant les lettres manquantes. (exercice 1 : variante)
m7cgp2_1.xml	Ecrire un mot illustré. (exercice 2)
m7cgp2_2.xml	Ecrire un mot illustré. (exercice 2: variante)
m7cgpr1_1.xml	Compléter des mots avec des graphies proposées. (remédiation 1)
m7cgpr1_2.xml	Compléter des mots avec des graphies proposées. (remédiation 1 : variante)
m7coe1_s1.xml	Parmi deux anagrammes (mots courts), repérer celui qui est lu par l’adulte. (exercice 1)
m7coe1_s2.xml	Parmi deux anagrammes (mots courts), repérer celui qui est lu par l’adulte. (exercice 1 : variante)
m7coe2.xml	Parmi deux anagrammes (mots complexes), repérer celui qui est lu par l’adulte. (exercice 2)
m7coer1.xml	Parmi trois anagrammes ( syllabes), repérer celui qui est lu par l’adulte. (remédiation 1)
m7cr1_1.xml	Répondre à une question portant sur un texte court entendu (caché). (remédiation 1)
m7cr1_2.xml	Répondre à une question portant sur un texte court entendu (caché). (remédiation 1 : variante)
m7cr2_1.xml	Répondre à une question portant sur un texte court entendu (caché). (remédiation 2)
m7cr2_2.xml	Répondre à une question portant sur un texte court entendu (caché). (remédiation 2 : variante)
m7fl1_s1.xml	Effectuer un classement de phrases en fonction de la forme. (exercice 1)
m7fl1_s2.xml	Effectuer un classement de phrases en fonction de la forme. (exercice 1 : variante)
m7fl2.xml	Sélectionner parmi deux la phrase contraire à la phrase donnée. (exercice 2)
m7flr1.xml	Repérer les négations dans des phrases. (remédiation 1)
m7v1_s1_1.xml	En s’aidant du contexte, retrouver parmi trois la définition d’un mot donné. (exercice 1)
m7v1_s1_2.xml	En s’aidant du contexte, retrouver parmi trois la définition d’un mot donné. (exercice 1 : variante)
m7v1_s2_1.xml	En s’aidant du contexte, retrouver parmi trois la définition d’un mot donné. (exercice 1 : variante)
m7v1_s2_2.xml	En s’aidant du contexte, retrouver parmi trois la définition d’un mot donné. (exercice 1 : variante)
m7v2.xml	En s’aidant du contexte, retrouver parmi trois la définition d’une expression donnée. (exercice 2)                    
m7vr1.xml	Trouver le mot correspondant à la définition donnée. (remédiation 1)